#####################
#     #   #   #   # #
# ### ### ### # ### #
# #   # #     #   # #
# # ### ### # # # # #
# #   #   # #   #   #
# # ##### ### ##### #
# # # # #   # #   # #
# ### # # ### ### # #
#     #       # #   #
##### ### ### # # ###
#           #   #   #
# # ######### ##### #
# # # #       #     #
### # ### # # # ### #
#     # # # # # #   #
# # ### # # # # ### #
# #     # # # #   # #
# ####### ### # ### #
# #         #     # #
#######A######A####A#
