################
#              #
#  #  #  ####  #
#  #  #     #  #
#  ##########  #
#           #  #
#  #######  #  #
#     #  #  #  #
####  #  #  ####
#        #     #
#############A##
